11111111111111111111
12000000000000000001
10111111111111111101
10100000000000000101
10111111101111011101
10000000111101010001
10111010000001011101
10101011111101010101
10101000000101010101
10101001110101010101
10101011010101010101
10101001010101010101
10101011010111010101
10101001010000010101
10101011011111110101
10101000000000010101
10101111111111010101
10100000000000010101
10111111111111010101
10100000000000010001
10110111011101110101
11101101110101010101
10000000000000010101
10111111111111010101
10100000000000010101
10101111111111110101
10101000000000010101
10101011111111110101
10101010000000000101
10101011111011111101
10101010001010000001
10101010111111111101
10101010131000000101
10101010101111110101
10101010100000000101
10101010111111110101
10100000000000000101
11111111111111111101
10000000000000000001
11111111111111111111
