11111111111111111111
12000000001000000001
11111111101011111111
10000000001000000001
11111110101111101111
10000000100000001001
11111111111111101011
10000000000000001001
11111111011111111101
10000001010000000001
11111011011111011101
10001000000000010101
10111111111111110101
10000000000000000101
11111111111111101101
10000000000000000001
10111111101111101111
11100000101000100001
10101110101010101111
10001010101010101001
10101000101010101101
10101111101010100001
10100000001010101101
10111101111010100101
10000100000010111101
10110111101110100001
10100000000000101111
10111111111010100131
10100000001111110101
10111110100000100101
10010010111110001101
10111010100011111101
10000000001000000001
10111111111111111111
10010000000000000001
10110110111111111101
10010010000000000101
10011110111111111101
10000000000000000001
11111111111111111111
