11111111111111111111
10000000100000000101
10111110101101111101
10100011111001000101
10101000001101110101
10111111000000100001
10101001011111110101
10100000000000000101
10100111111101110101
10110100000101010111
10010111110111000001
10110111010000011011
10010010011001001011
10111000110011101001
10101101100110001101
10100000101100100101
10001110101001110101
11111000101011010101
10001101101110000101
10102100030000110101
10111111101011100101
10000100101010110101
10111101101010111101
10101001001010100001
10100011101010001001
10101110100010111101
10101000111110100101
10100010100000110101
10110110111010010101
10100100101111010101
10111101101001010101
10000001000000010001
10101111011101111101
10101000000101001001
10101011110101011011
10101011010101011011
10101001010101000001
11101111011101111101
10000000000000010001
11111111111111111111
